111111111111111111111111111111111111111111
100000000000000000000000000000000000000001
101111001100111001111101001010111110111101
101000010010100100010001101010001000100001
101110010010111000010001011010001000111001
101000010010100100010001001010001000100001
101000001100100100010001001010001000111101
100000000000000000000000000000000000000001
111111111111111111111111111111111111111111
1E0010C00000000000000000000000000000000001
101110101111111110111111111111011111010001
10100010100001000001C000010100010100000111
101111101110101111101110101011101011101001
100000100010100000001000101000101000001101
111110111010111110111010111010111011101011
1C0000000001000001010001000000010000011111
111111111110111011111011101111001110111001
10000C100010001000000000001000000010001011
101111101111110001111101110101111110111111
1P0000000000000010000010001000000C00100111
111111111111111111111111111111111111111111
